{
    "tiles": [
        [
            0, 11, 11, 11, 3, 7, 11, 11, 11, 11, 0, 11, 11, 11, 0, 11
        ],
        [
            0, 13, 11, 11, 0, 12, 11, 11, 3, 1, 6, 8, 15, 11, 4, 2
        ],
        [
            0, 4, 1, 1, 7, 11, 11, 11, 0, 11, 11, 0, 11, 11, 11, 0
        ],
        [
            0, 11, 11, 11, 0, 11, 3, 2, 0, 11, 14, 5, 11, 11, 14, 7
        ],
        [
            4, 2, 11, 14, 10, 1, 5, 9, 7, 11, 11, 11, 11, 11, 11, 0
        ],
        [
            11, 12, 11, 11, 0, 11, 11, 12, 0, 11, 11, 3, 1, 1, 1, 5
        ],
        [
            11, 11, 11, 11, 12, 11, 11, 11, 0, 3, 1, 6, 15, 11, 11, 11
        ],
        [
            11, 11, 11, 11, 11, 11, 3, 1, 5, 0, 11, 11, 11, 11, 11, 10
        ],
        [
            10, 11, 11, 11, 11, 11, 0, 3, 1, 5, 11, 11, 11, 11, 11, 11
        ],
        [
            11, 11, 11, 14, 8, 1, 5, 0, 11, 11, 11, 11, 11, 11, 11, 11
        ],
        [
            3, 1, 1, 1, 5, 11, 11, 0, 13, 11, 11, 0, 11, 11, 13, 11
        ],
        [
            0, 11, 11, 11, 11, 11, 11, 9, 7, 3, 1, 10, 11, 11, 4, 2
        ],
        [
            9, 1, 7, 11, 3, 1, 11, 0, 4, 5, 11, 0, 11, 11, 11, 0
        ],
        [
            0, 11, 0, 11, 0, 11, 11, 0, 11, 11, 11, 9, 1, 1, 2, 0
        ],
        [
            4, 2, 11, 1, 6, 8, 1, 5, 11, 11, 13, 0, 11, 11, 12, 0
        ],
        [
            11, 0, 11, 11, 11, 0, 11, 11, 11, 11, 9, 5, 11, 11, 11, 0
        ]
    ],
    "entities": [
        [
            0, 6, 0, 0, 0, 0, 0, 0, 0, 0, 6, 0, 0, 0, 0, 0
        ],
        [
            0, 1, 0, 0, 0, 0, 0, 0, 0, 0, 2, 0, 0, 0, 0, 0
        ],
        [
            0, 0, 2, 0, 0, 0, 0, 0, 0, 0, 0, 0, 0, 0, 0, 0
        ],
        [
            0, 4, 0, 0, 0, 0, 0, 0, 0, 0, 0, 0, 0, 0, 0, 0
        ],
        [
            0, 0, 0, 0, 0, 0, 0, 0, 0, 0, 0, 0, 0, 0, 0, 0
        ],
        [
            0, 0, 0, 0, 0, 0, 0, 0, 0, 0, 0, 0, 0, 0, 0, 0
        ],
        [
            0, 0, 0, 0, 0, 0, 0, 0, 0, 0, 0, 0, 0, 0, 0, 0
        ],
        [
            0, 0, 0, 0, 0, 0, 0, 0, 3, 0, 0, 0, 0, 0, 0, 0
        ],
        [
            0, 0, 0, 0, 0, 0, 0, 0, 0, 0, 0, 0, 0, 0, 0, 0
        ],
        [
            0, 0, 0, 0, 0, 0, 0, 0, 0, 0, 0, 0, 0, 0, 0, 0
        ],
        [
            0, 0, 0, 0, 0, 0, 0, 0, 0, 0, 0, 0, 0, 0, 0, 0
        ],
        [
            0, 0, 0, 0, 0, 0, 0, 0, 0, 0, 0, 0, 0, 0, 0, 0
        ],
        [
            0, 0, 0, 0, 0, 0, 0, 0, 0, 0, 0, 0, 0, 0, 0, 0
        ],
        [
            0, 0, 0, 0, 0, 0, 0, 0, 0, 0, 0, 0, 0, 0, 0, 0
        ],
        [
            0, 0, 5, 0, 0, 0, 0, 0, 0, 0, 0, 0, 0, 0, 0, 0
        ],
        [
            0, 0, 6, 0, 0, 0, 0, 0, 0, 0, 0, 0, 0, 0, 0, 0
        ]
    ]
}