{
    "tiles": [
        [
            0, 11, 11, 11, 3, 7, 11, 11, 11, 11, 0, 11, 11, 11, 0, 11
        ],
        [
            0, 13, 11, 11, 0, 12, 11, 11, 3, 1, 6, 8, 15, 11, 4, 2
        ],
        [
            0, 4, 1, 1, 7, 11, 11, 11, 0, 11, 11, 0, 11, 11, 11, 0
        ],
        [
            0, 11, 11, 11, 0, 11, 3, 2, 0, 11, 14, 5, 11, 11, 14, 7
        ],
        [
            4, 8, 1, 1, 10, 1, 5, 9, 7, 11, 11, 11, 11, 11, 11, 0
        ],
        [
            11, 12, 11, 11, 0, 11, 11, 12, 0, 11, 11, 3, 1, 1, 1, 5
        ],
        [
            11, 11, 11, 11, 12, 11, 11, 11, 0, 3, 1, 6, 15, 11, 11, 11
        ],
        [
            13, 11, 11, 11, 11, 11, 3, 1, 6, 7, 11, 11, 11, 11, 14, 8
        ],
        [
            6, 15, 11, 11, 11, 11, 9, 8, 1, 5, 11, 11, 11, 11, 11, 12
        ],
        [
            11, 11, 11, 14, 8, 1, 5, 0, 11, 11, 11, 13, 11, 11, 11, 11
        ],
        [
            3, 1, 1, 1, 5, 11, 11, 0, 13, 11, 11, 0, 11, 11, 13, 11
        ],
        [
            0, 11, 11, 11, 11, 11, 11, 9, 7, 3, 1, 10, 1, 1, 6, 2
        ],
        [
            9, 15, 11, 11, 3, 15, 11, 0, 4, 5, 11, 0, 11, 11, 11, 0
        ],
        [
            0, 11, 11, 11, 0, 11, 11, 0, 11, 11, 11, 9, 1, 1, 2, 0
        ],
        [
            4, 2, 11, 14, 6, 8, 1, 5, 11, 11, 13, 0, 11, 11, 12, 0
        ],
        [
            11, 0, 11, 11, 11, 0, 11, 11, 11, 11, 9, 5, 11, 11, 11, 0
        ]
    ],
    "entities": [
        [
            0, 6, 0, 0, 0, 0, 0, 0, 0, 0, 6, 0, 0, 0, 0, 0
        ],
        [
            0, 1, 0, 0, 0, 0, 0, 0, 0, 0, 2, 0, 0, 0, 0, 0
        ],
        [
            0, 0, 2, 0, 0, 0, 0, 0, 0, 0, 0, 0, 0, 0, 0, 0
        ],
        [
            0, 4, 0, 0, 0, 0, 0, 0, 0, 0, 0, 0, 0, 0, 0, 0
        ],
        [
            0, 0, 0, 0, 0, 0, 0, 0, 0, 0, 0, 0, 0, 0, 0, 0
        ],
        [
            0, 0, 0, 0, 0, 0, 0, 0, 0, 0, 0, 0, 0, 0, 0, 0
        ],
        [
            0, 0, 0, 0, 0, 0, 0, 0, 0, 0, 0, 0, 0, 0, 0, 0
        ],
        [
            0, 0, 0, 0, 0, 0, 0, 0, 3, 0, 0, 0, 0, 0, 0, 0
        ],
        [
            0, 0, 0, 0, 0, 0, 0, 0, 0, 0, 0, 0, 0, 0, 0, 0
        ],
        [
            0, 0, 0, 0, 0, 0, 0, 0, 0, 0, 0, 0, 0, 0, 0, 0
        ],
        [
            0, 0, 0, 0, 0, 0, 0, 0, 0, 0, 0, 0, 0, 0, 0, 0
        ],
        [
            0, 0, 0, 0, 0, 0, 0, 0, 0, 0, 0, 0, 0, 0, 0, 0
        ],
        [
            0, 0, 0, 0, 0, 0, 0, 0, 0, 0, 0, 0, 0, 0, 0, 0
        ],
        [
            0, 0, 0, 0, 0, 0, 0, 0, 0, 0, 0, 0, 0, 0, 0, 0
        ],
        [
            0, 0, 5, 0, 0, 0, 0, 0, 0, 0, 0, 0, 0, 0, 0, 0
        ],
        [
            0, 0, 6, 0, 0, 0, 0, 0, 0, 0, 0, 0, 0, 0, 0, 0
        ]
    ]
}