{
    "tiles": [
        [
            11, 0, 11, 11, 11, 11, 11, 11, 11, 11, 0, 11, 11, 11, 11, 11
        ],
        [
            11, 0, 11, 11, 11, 11, 11, 11, 11, 11, 0, 11, 11, 11, 11, 11
        ],
        [
            11, 9, 2, 11, 11, 3, 1, 1, 1, 1, 5, 11, 11, 11, 11, 11
        ],
        [
            11, 0, 0, 11, 3, 5, 11, 11, 11, 11, 11, 11, 11, 11, 11, 11
        ],
        [
            11, 11, 0, 3, 5, 11, 11, 11, 11, 11, 11, 11, 11, 11, 11, 11
        ],
        [
            11, 11, 9, 5, 11, 11, 11, 8, 11, 11, 7, 6, 11, 11, 11, 11
        ],
        [
            11, 11, 0, 11, 11, 11, 11, 11, 11, 11, 11, 11, 11, 11, 11, 10
        ],
        [
            11, 11, 9, 1, 1, 1, 1, 1, 1, 1, 1, 1, 1, 1, 1, 2
        ],
        [
            11, 11, 0, 11, 3, 1, 1, 1, 1, 1, 1, 1, 1, 1, 1, 5
        ],
        [
            11, 11, 0, 11, 4, 1, 1, 1, 1, 1, 1, 1, 1, 1, 1, 2
        ],
        [
            11, 11, 9, 1, 1, 1, 1, 1, 1, 1, 1, 11, 11, 11, 11, 0
        ],
        [
            11, 11, 0, 11, 11, 11, 11, 11, 11, 11, 11, 11, 11, 11, 11, 0
        ],
        [
            11, 11, 0, 11, 11, 11, 11, 11, 11, 11, 11, 11, 11, 11, 11, 0
        ],
        [
            11, 11, 0, 11, 11, 11, 11, 11, 11, 11, 11, 11, 11, 11, 11, 0
        ],
        [
            11, 11, 0, 11, 11, 11, 11, 11, 11, 11, 11, 11, 11, 11, 11, 0
        ],
        [
            11, 11, 0, 11, 11, 11, 11, 11, 11, 11, 11, 11, 11, 11, 11, 0
        ]
    ],
    "entities": [
        [
            0, 6, 0, 0, 0, 0, 0, 0, 0, 0, 6, 0, 0, 0, 0, 0
        ],
        [
            0, 1, 0, 0, 0, 0, 0, 0, 0, 0, 2, 0, 0, 0, 0, 0
        ],
        [
            0, 0, 2, 0, 0, 0, 0, 0, 0, 0, 0, 0, 0, 0, 0, 0
        ],
        [
            0, 4, 0, 0, 0, 0, 0, 0, 0, 0, 0, 0, 0, 0, 0, 0
        ],
        [
            0, 0, 0, 0, 0, 0, 0, 0, 0, 0, 0, 0, 0, 0, 0, 0
        ],
        [
            0, 0, 0, 0, 0, 0, 0, 0, 0, 0, 0, 0, 0, 0, 0, 0
        ],
        [
            0, 0, 0, 0, 0, 0, 0, 0, 0, 0, 0, 0, 0, 0, 0, 0
        ],
        [
            0, 0, 0, 0, 0, 0, 0, 0, 3, 0, 0, 0, 0, 0, 0, 0
        ],
        [
            0, 0, 0, 0, 0, 0, 0, 0, 0, 0, 0, 0, 0, 0, 0, 0
        ],
        [
            0, 0, 0, 0, 0, 0, 0, 0, 0, 0, 0, 0, 0, 0, 0, 0
        ],
        [
            0, 0, 0, 0, 0, 0, 0, 0, 0, 0, 0, 0, 0, 0, 0, 0
        ],
        [
            0, 0, 0, 0, 0, 0, 0, 0, 0, 0, 0, 0, 0, 0, 0, 0
        ],
        [
            0, 0, 0, 0, 0, 0, 0, 0, 0, 0, 0, 0, 0, 0, 0, 0
        ],
        [
            0, 0, 0, 0, 0, 0, 0, 0, 0, 0, 0, 0, 0, 0, 0, 0
        ],
        [
            0, 0, 5, 0, 0, 0, 0, 0, 0, 0, 0, 0, 0, 0, 0, 0
        ],
        [
            0, 0, 6, 0, 0, 0, 0, 0, 0, 0, 0, 0, 0, 0, 0, 0
        ]
    ]
}